*******X**
*X*XXXXX**
*******X**
*X*XXX****
*******X*X
*X*X*X*X*X
*X*X*X****
*X*****X**
*XX**X*XXX
**X**X****