********X*
*XXXX*X***
****XXXXXX
*X*XX*****
*X****XXX*
*XX*XXX*XX
*XX******X
**XX*XXX**
X**X***X*X
**XX*X*X**
