***X***********
*X***XXXXXXXXXX
*X*XXX*X**X***X
**********X****
*X*XXX*XX*X*XXX
*X***X*XX*X*X**
X**XXX********X
*****X*X**X*X**
****XX**X*XX*XX
**X**XX*XXX****
**X***X****XX**
*XX**XXX*X*X***
*X**XX****XX*X*
*XX*XXXX*****X*
*******XX*XX*X*