**********
**XXXXXXX*
**X*X***X*
**X*X*X*X*
**X*X*X*X*
**X*X*X*X*
**X*X*X***
**X*X*XXXX
****X****X
****XXXX**